....;;;..;;..
.!.!;!;!;!;!;
.;...........
.!;!;!;!!!!!.
;............
.!;!;!.!;!;!;
;....;......!
.!;!.!;!.!;!;
..;..........
;!;!;!;!;!;!;
;;...........