....;;;..;;..
.!!!!!!!!!!!;
!;...........
..!!!!!!!!!!!
;............
!!!!!!!!!!!.;
;....;......!
.!!!!!;!!!!!;
..;..!.......
!!!!;!!!!!!!!
;;...........