..!.......;;;
.!;!;!;!;!;!.
;..........;!
;!;!;!;!;!!!.
;..;.....;..;
.!;!;!;!;!;!;
;....;.;.;!.;
;!.!;!;!;!.!.
;.;.;....;!..
.!!!.!;!;!.!;
.;...;;;...;;